{
  "meta": {
    "app": "Tiled",
    "version": "1.0",
    "format": "1.2",
    "image": "tileset.png",
    "tilewidth": 32,
    "tileheight": 32,
    "type": "map"
  },
  "mapdata": {
    "data": [
      [2, 2, 2, 2, 2, 2, 2, 2, 2, 2],
      [2, 0, 0, 0, 2, 0, 0, 0, 0, 2],
      [2, 0, 0, 0, 3, 0, 0, 0, 0, 2],
      [2, 2, 2, 2, 2, 2, 2, 0, 2, 2],
      [2, 0, 0, 0, 2, 0, 0, 0, 0, 2],
      [2, 0, 0, 0, 0, 0, 0, 0, 0, 2],
      [2, 2, 2, 2, 2, 0, 3, 0, 0, 2],
      [2, 0, 0, 0, 2, 0, 0, 4, 0, 2],
      [2, 0, 3, 0, 0, 0, 0, 0, 0, 2],
      [2, 2, 2, 2, 2, 2, 2, 2, 2, 2]
    ],
    "tileWidth": 32,
    "tileHeight": 32,
    "width": 10,
    "height": 10
  }
}
